0000010000000000000000000
0000010000000000000000000
0000010000000000000000000
0000010000000000000000000
0000010000000000000000000
1111111111111111111110000
0000010000000000000010000
0000010000000000000010000
0000010000000000000010000
0000010000000000000010000
0000010000000000000010000
0000010000000000000010000
0000010000000000000010000
0000010000000000000010000
0000010000000000000010000
0000010000000000000010000
0000010000000000000010000
0000010000000000000010000
0000010000000000000010000
0000010000000000000010000
0000011111111111111110000
0000000000000000000000000
0000000000000000000000000
0000000000000000000000000
0000000000000000000000000