0000212000000000000000000
0000212000000000000000000
0000010000000000000000000
0000010000000000000000000
0000010000000000000000000
0000010111111111111110000
0000010100000000000010000
0000010101111111111010000
0000010101000000001010000
2200010101000000001010000
1111111111111111101010000
2200010101000000101010000
0000010101000000101010000
0000010101000000101010000
0000010101000000101010000
0000010101000000101010000
0000010101111111101010000
0000010100000000001010000
0000010111111111111010000
0000010000000000000010000
0000011111111111111110000
0000000000000000000000000
0000000000000000000000000
0000000000000000000000000
0000000000000000000000000