2222222222211122222222222
2200000000211120000000022
2200000000011100000000022
2200000000011100000000022
2200000000011100000000022
2200000000011100000000022
2200000000011100000000022
2200000000011100000000022
2200000000011100000000022
2200000000011100000000022
2200000000011100000000022
2200000000011100000000022
2200000000011100000000022
2200000000011100000000022
2200000000011100000000022
2200000000011100000000022
2200000000011100000000022
2200000000011100000000022
2200000000011100000000022
2200000000011100000000022
2200000000011100000000022
2200000000011100000000022
2200000000011100000000022
2200000000211120000000022
2222222222211122222222222