HHHHH1HHHHHHHHHHHHHHHHHHH
HHHHH1HHHHHHHHHHHHHHHHHHH
HH000100000000000000000HH
HH000100000000000000000HH
HH000100000000000000000HH
11111111111111111111100HH
HH000122222222222222100HH
HH000122222222222222100HH
HH000122222222222222100HH
HH000122222222222222100HH
HH000122222222222222100HH
HH000122222000022222100HH
HH000122222000022222100HH
HH000122222000022222100HH
HH000122222000022222100HH
HH000122222222222222100HH
HH000122222222222222100HH
HH000122222222222222100HH
HH000122222222222222100HH
HH000122222222222222100HH
HH000111111111111111100HH
HH000000000000000000000HH
HH000000000000000000000HH
HHHHHHHHHHHHHHHHHHHHHHHHH
HHHHHHHHHHHHHHHHHHHHHHHHH